                             '
 ############################'
 #............##............#'
 #.####.#####.##.#####.####.#'
 #.#  #.#   #.##.#   #.#  #.#'
 #.####.#####.##.#####.####.#'
 #..........................#'
 #.####.##.########.##.####.#'
 #.####.##.########.##.####.#'
 #......##....##....##......#'
 ######.#####.##.#####.######'
      #.#####.##.#####.#     '
      #.##          ##.#     '
      #.## ##====## ##.#     '
 ######.## # A    # ##.######'
 #     .   # A  A #   .     #'
 ######.## #  A   # ##.######'
      #.## ######## ##.#     '
      #.##          ##.#     '
      #.## ######## ##.#     '
 ######.## ######## ##.######'
 #............##............#'
 #.####.#####.##.#####.####.#'
 #.####.#####.##.#####.####.#'
 #...##................##...#'
 ###.##.##.########.##.##.###'
 ###.##.##.########.##.##.###'
 #......##....##....##......#'
 #.##########.##.##########.#'
 #.##########.##.##########.#'
 #...................@......#'
 ############################'
                             '
