                     '
 ####################'
 #....#........#....#'
 #.##.#.######.#.##.#'
 #.#..............#.#'
 #.#.##.#====#.##.#.#'
 #......# AA #......#'
 #.#.##.######.##.#.#'
 #.#...... @......#.#'
 #.##.#.######.#.##.#'
 #....#........#....#'
 ####################'
                     '
